0                                  0        
0                                  0        
0                                  0        
0                                  0        
0                                  0        
0                                  0        
0                                  0        
0 P                                0        
0           CCCCCCCCCC             0        
0           CCCCCCCCCC             0        
0          CCCCCCCCCCCC           G0        
0        000000000000000          G0        
000000000000000000000000000000000000